%%%%%%%%
%P     %
% .% . %
%  %   %
% .% . %
%     G%
%%%%%%%%
