%%%%%%%
% P   %
% %%% %
% %.  %
% %%% %
%. G  %
%%%%%%%
